+-----------------+
|        1 2   3  |
|6 5 8 9 3        |
|      7 8     9  |
|7     2 5   4    |
|  1 5 3 4   9 6 7|
|  8             5|
|5 4       1   7  |
|1 3 9   2     5  |
|8                |
+-----------------+
